first	last
Joseph	Barbaro
Joseph	Berrafati
Rory	Buckman
Michael	Carnavos
Matt	D'Anieri
Tom	DePalma
Andrew	Doherty Munro
Thomas	Doyle
John	Greenberg
James	Gregoire
Chris	Gregory
Peter	Horvath
Dylan	Jones
Michael	Kennedy
Aiden	Lewis
Sam	Little
Roman	Lovell
Dylan	McEniry
Jackson	Mihm
Patrick	Nero
David	Ng'Etich
Colin	Raposo
Brian	Reaney
Harry	Steinberg
Christian	Swenson
Dalton	Tanner
Hiroto	Watanabe
Taylor	Wurts
